111111111111111111
100000000000000E01
100000000000001001
1P000000C001000001
111111111111111111