111111111111111111
1000000000000E0011
10000000C000001001
1P00C0000001000001
111111111111111111
