1111111111111111111111111111111111
1C1001110000000C00Z00C000000000111
101100011000000000000000Z00C000111
1011110100100000111111C00000010001
1010101001000001010011110000000111
1000010010101010001001000000010011
100000C0000000Z0000C00000Z00000001
1P0000000C00C0000000Z00000000001E1
1111111111111111111111111111111111