1111111111111111111111111111111111
1C1001110000000C00000C000000000111
101100011000000000000000000C000001
1011110100100000111111000000010111
1010010100100000101001111000000111
1000010010101010001001000000010111
100000C000000000000C00000000000001
1P0000000C00C0000000000000000001E1
1111111111111111111111111111111111