1111111111111111111111111111111111
1C0000000000000C00000C000000000001
100000000000000000000000000C000001
1011110100100000111001000000010111
1010010100100000101001000000000101
1000010010101010001001000000010101
100000C000000000000C000000000000C1
1P0000000C00C0000000000000000000E1
1111111111111111111111111111111111