1111111111111
10C000L000001
1000000LE0001
1P00000000001
1111111111111