1111111111111
10C000Z000001
1P000000ZE001
1111111111111