1111111111111
100P0E0C00001
1111111111111