1111111111111
10C0000000001
1P0000000E001
1111111111111