1111111111111
1111111000111
100P000C1E101
1000000C01001
1111111111111