11111
10C01
10C01
10C01
10C01
10C01
1P001
1C0E1
11111