1111111111111111111111111111111111
1C1001110000L00C00000C000000000111
1011000110000000000000L0000C000111
1011110100100000111111C00000010001
101L101001000001010011110000000111
1000110010101010001001000000010011
100000C000000000000C01000000100001
1P00000000000100000001000L01E00101
1C1001110000L00C00000C000000100111
1011000110000000000000L0000C000111
1011110100100000111111C00000010001
101L101001000001010011110000000111
1000110010101010001001000000010011
100000C000000000000C01000000000001
1000000000000100000001000L00000101
1C1001110000L00C00000C000000000111
1011000110000000000000L0000C000111
1011110100100000111111C00000010001
101L101001000001010011110000000111
1000110010101010001001000000010011
100000C000000000000C01000000000001
1000000000000100000001000L00000101
1C1001110000L00C00000C000000000111
1011000110000000000000L0000C000111
1011110100100000111111C00000010001
101L101001000001010011110000000111
1000110010101010001001000000010011
1111111111111111111111111111111111