1111111111111111111111111111111111
1C1001110000Z00C00000C000000000111
1011000110000000000000000Z0C000111
1011110100100000111111C00000010001
101Z101001000001010011110000000111
1000010010101010001001000000010011
100000C000000000000C00000000000001
1P0000000C00C000000000000Z000001E1
1111111111111111111111111111111111