11111111111111111111111111111111111111111111111111
1C10C01110000Z00C000C00C00000000011001111010110011
101Z101001CC00000101001111000000011001111010111111
1011000110000C000000000Z0000C000110011110101010011
1011000110000000000000Z0000C0001100111101011110011
1011110100100000111111CC00CC0000100010001101010001
101Z1010010000010C1001111000000011001111010C001011
1000110C010C10101000100100000001001100011010111001
100011001010C101000C100100000C010011C0001101011001
1000110C01010101000C100C10000000100110001101011001
101Z101001000001010011110000000C110011110100000111
10001CC10010101C010CC00100100000001001100011000001
1000110010C101010001001000000010011000110101011001
100011001010101000100100C0000010011000110101011001
1P0000C0C00000000000C010000001E0000000110101010011
10001100101010100010010000000100110001101000001001
10001100C10101010001001000C000010011C0001101011001
1C100111000C0Z00C00000C000000000110011110101111011
101Z1010010000010100111100000001100111101010000111
101100C0110000000000000ZC0000C00011001111010111011
1011000110000000000000Z000C0C000110011110101111011
1011110100100000111111C00000010001000C110101010001
1C01Z10100100000101001111C000000011001111010111111
100011001010101000100100000C0010011000110101101001
10001100101C01010001001C00000001001100011010111001
1000110C010101010001001000C00001001100011010011001
101Z10100100000101001111000C000011001111C010111111
10001100C101010100010010000C0001001100011011110101
11111111111111111111111111111111111111111111111111