111111111111111111111111111111111111111111111111111111111
10000000C0C0000000000CC00000C0000000C0000000000C000000001
10000000111000000C000000C00C001110000000C000000C000000001
10000000C01000000000C0C00000C00000000C000000000000C000001
1000000010C000000000011100001100000000000C00000C000000001
1P00000010C00000000001C00000C000000000000000C00000000C0E1
100000000000000000000000000000000000000000000000000000001
100000000000000000000000000000000000000000000000000000001
100000000000000000000000000000000000000000000000000000001
100000000000000000000000000000000000000000000000000000001
100000000000000000000000000000000000000000000000000000001
100000000000000000000000000000000000000000000000000000001
100000000000000000000000000000000000000000000000000000001
100000000000000000000000000000000000000000000000000000001
100000000000000000000000000000000000000000000000000000001
100000000000000000000000000000000000000000000000000000001
100000000000000000000000000000000000000000000000000000001
100000000000000000000000000000000000000000000000000000001
100000000000000000000000000000000000000000000000000000001
100000000000000000000000000000000000000000000000000000001
100000000000000000000000000000000000000000000000000000001
100000000000000000000000000000000000000000000000000000001
100000000000000000000000000000000000000000000000000000001
100000000000000000000000000000000000000000000000000000001
100000000000000000000000000000000000000000000000000000001
100000000000000000000000000000000000000000000000000000001
100000000000000000000000000000000000000000000000000000001
100000000000000000000000000000000000000000000000000000001
111111111111111111111111111111111111111111111111111111111